LL,PL,OMC,MDD,PI,SoilType
35,20,15,1.8,15,Clay
20,18,12,1.9,2,Sand
40,22,16,1.7,18,Silty Clay
25,19,13,1.85,6,Sandy Clay
45,24,17,1.6,21,Clay
30,20,14,1.82,10,Loam
18,15,11,1.91,3,Sandy Loam
50,30,18,1.55,20,Clay
38,26,16,1.7,12,Silty Clay
28,22,14,1.88,6,Loam

